XXXXXXXXXXXXXXXXXXXXX
XSX X XXXXX         X
XXXXXXXXXXX         X
XXX   XXX X         X
XXX   XXXXX         X
XXX   X X X         X
XXX   XXXXX         X
XXX   X   X         X
XXXXXXX   X         X
XXXXXXXXXXX         X
XXXXXXXXXXXXXXXXXXXXX
XXXXXXXXXXXXXXX XXXXX
XXXXXXXXXXXXXXXXXXXXX
